phenostring	category
Disorders of iron metabolism	hematopoietic
Celiac disease	digestive
Diseases of hair and hair follicles	dermatologic
Sebaceous cyst	dermatologic
Contracture of palmar fascia [Dupuytren's disease]	musculoskeletal
Fasciitis	musculoskeletal
Disorders of muscle, ligament, and fascia	musculoskeletal
Diseases of sebaceous glands	dermatologic
Disorders of mineral metabolism	endocrine/metabolic
Ankylosing spondylitis	musculoskeletal
Congenital deficiency of other clotting factors (including factor VII)	hematopoietic
Cholelithiasis and cholecystitis	digestive
Disorders of bilirubin excretion	endocrine/metabolic
Congenital coagulation defects	hematopoietic
Cholelithiasis	digestive
Atrial fibrillation and flutter	circulatory system
Psoriasis	dermatologic
Psoriasis and related disorders	dermatologic
Type 1 diabetes	endocrine/metabolic
Rheumatoid arthritis	musculoskeletal
Coagulation defects	hematopoietic
Psoriasis vulgaris	dermatologic
Diabetes mellitus	endocrine/metabolic
Type 2 diabetes	endocrine/metabolic
Rheumatoid arthritis and other inflammatory polyarthropathies	musculoskeletal
Other inflammatory spondylopathies	musculoskeletal
Phlebitis and thrombophlebitis of lower extremities	circulatory system
Phlebitis and thrombophlebitis	circulatory system
Other non-epithelial cancer of skin	neoplasms
Coronary atherosclerosis	circulatory system
Cholelithiasis with other cholecystitis	digestive
Dementias	mental disorders
Hypothyroidism	endocrine/metabolic
Skin cancer	neoplasms
Hypothyroidism NOS	endocrine/metabolic
Cardiac dysrhythmias	circulatory system
Multiple sclerosis	neurological
Varicose veins of lower extremity	circulatory system
Ischemic Heart Disease	circulatory system
Disorders of lipoid metabolism	endocrine/metabolic
Hyperlipidemia	endocrine/metabolic
Varicose veins	circulatory system
Breast cancer	neoplasms
Breast cancer [female]	neoplasms
Hypercholesterolemia	endocrine/metabolic
Malignant neoplasm of female breast	neoplasms
Type 1 diabetes with ophthalmic manifestations	endocrine/metabolic
Circulatory disease NEC	circulatory system
Delirium dementia and amnestic and other cognitive disorders	mental disorders
Alzheimer's disease	mental disorders
Gout	endocrine/metabolic
Other disorders of circulatory system	circulatory system
Asthma	respiratory
Gout and other crystal arthropathies	endocrine/metabolic
Myocardial infarction	circulatory system
Inflammatory bowel disease and other gastroenteritis and colitis	digestive
Calculus of bile duct	digestive
Hypertension	circulatory system
Other chronic ischemic heart disease, unspecified	circulatory system
Hematuria	genitourinary
Essential hypertension	circulatory system
Angina pectoris	circulatory system
Ulcerative colitis	digestive
Inguinal hernia	digestive
Type 1 diabetes with ketoacidosis	endocrine/metabolic
Diabetic retinopathy	endocrine/metabolic
Corneal dystrophy	sense organs
Diverticulosis and diverticulitis	digestive
Diverticulosis	digestive
Nasal polyps	respiratory
Psoriatic arthropathy	dermatologic
Cataract	sense organs
Thyrotoxicosis with or without goiter	endocrine/metabolic
Pulmonary heart disease	circulatory system
Abdominal hernia	digestive
Cancer of prostate	neoplasms
Other biliary tract disease	digestive
Benign neoplasm of skin	neoplasms
Benign neoplasm of colon	neoplasms
Ileostomy status	digestive
Cholecystitis without cholelithiasis	digestive
Hypoglycemia	endocrine/metabolic
Regional enteritis	digestive
Corneal opacity and other disorders of cornea	sense organs
Melanomas of skin	neoplasms
Fracture of radius and ulna	injuries & poisonings
Melanomas of skin, dx or hx	neoplasms
Benign neoplasm of unspecified sites	neoplasms
Overweight, obesity and other hyperalimentation	endocrine/metabolic
Obesity	endocrine/metabolic
Polymyalgia Rheumatica	musculoskeletal
Graves' disease	endocrine/metabolic
Postinflammatory pulmonary fibrosis	respiratory
Cholelithiasis with acute cholecystitis	digestive
Allergy/adverse effect of penicillin	injuries & poisonings
Chronic liver disease and cirrhosis	digestive
Uterine leiomyoma	neoplasms
Umbilical hernia	digestive
Nontoxic multinodular goiter	endocrine/metabolic
Poisoning by antibiotics	injuries & poisonings
Unstable angina (intermediate coronary syndrome)	circulatory system
Type 1 diabetes with neurological manifestations	endocrine/metabolic
Fracture of upper limb	injuries & poisonings
Senile cataract	sense organs
Actinic keratosis	dermatologic
Other disorders of metabolism	endocrine/metabolic
Hyperplasia of prostate	genitourinary
Benign neoplasm of uterus	neoplasms
Calculus of kidney	genitourinary
Emphysema	respiratory
Nodular lymphoma	neoplasms
Macular degeneration (senile) of retina NOS	sense organs
Other chronic nonalcoholic liver disease	digestive
Degeneration of macula and posterior pole of retina	sense organs
Benign neoplasm of other parts of digestive system	neoplasms
Anal and rectal polyp	digestive
Polycythemia vera	neoplasms
Vascular dementia	mental disorders
Appendiceal conditions	digestive
Myeloproliferative disease	neoplasms
Swelling of limb	symptoms
Unspecified monoarthritis	musculoskeletal
Diaphragmatic hernia	digestive
Other hemoglobinopathies	hematopoietic
Substance addiction and disorders	mental disorders
Appendicitis	digestive
Genital prolapse	genitourinary
Glaucoma	sense organs
Other disorders of gallbladder	digestive
Nontoxic nodular goiter	endocrine/metabolic
Retinal detachments and defects	sense organs
Non-Hodgkins lymphoma	neoplasms
Lipoma	neoplasms
Alcohol-related disorders	mental disorders
Urinary calculus	genitourinary
Unspecified diffuse connective tissue disease	dermatologic
Peripheral vascular disease, unspecified	circulatory system
Seborrheic keratosis	dermatologic
Uveitis, noninfectious or NOS	sense organs
Polyp of corpus uteri	genitourinary
Internal derangement of knee	injuries & poisonings
Type 2 diabetes with ophthalmic manifestations	endocrine/metabolic
Acquired absence of breast	neoplasms
Sarcoidosis	dermatologic
Other disorders of soft tissues	musculoskeletal
Other and unspecified coagulation defects	hematopoietic
Type 1 diabetes with renal manifestations	endocrine/metabolic
Other peripheral nerve disorders	neurological
Acute appendicitis	digestive
Hereditary hemolytic anemias	hematopoietic
Lipoma of skin and subcutaneous tissue	neoplasms
Sicca syndrome	dermatologic
Syncope and collapse	symptoms
Malignant neoplasm of bladder	neoplasms
Congenital anomalies of great vessels	congenital anomalies
Cholesterolosis of gallbladder	digestive
Cancer of bladder	neoplasms
Other anemias	hematopoietic
Hemorrhoids	circulatory system
Colorectal cancer	neoplasms
Chronic airway obstruction	respiratory
Cancer of urinary organs (incl. kidney and bladder)	neoplasms
Fracture of hand or wrist	injuries & poisonings
Degenerative skin conditions and other dermatoses	dermatologic
Hallux valgus (Bunion)	musculoskeletal
Diffuse diseases of connective tissue	dermatologic
Ganglion and cyst of synovium, tendon, and bursa	musculoskeletal
Cancer of other lymphoid, histiocytic tissue	neoplasms
Irregular menstrual cycle/bleeding	genitourinary
Anal and rectal conditions	digestive
Osteoarthrosis	musculoskeletal
Other retinal disorders	sense organs
Tobacco use disorder	mental disorders
Disorders of plasma protein metabolism	endocrine/metabolic
Excessive or frequent menstruation	genitourinary
Osteoporosis NOS	musculoskeletal
Hydrocele	genitourinary
Other specified peripheral vascular diseases	circulatory system
Duodenal ulcer	digestive
Erythematous conditions	dermatologic
Urinary incontinence	genitourinary
Other disorders of biliary tract	digestive
Systemic lupus erythematosus	dermatologic
Cellulitis and abscess of leg, except foot	dermatologic
Cellulitis and abscess of arm/hand	dermatologic
Osteoarthritis; localized	musculoskeletal
Simple and unspecified goiter	endocrine/metabolic
Carcinoma in situ of skin	neoplasms
Cellulitis and abscess of foot, toe	dermatologic
Obstetrical/birth trauma	pregnancy complications
Altered mental status	mental disorders
Neurological disorders	mental disorders
Femoral hernia	digestive
Disorders of penis	genitourinary
Duodenitis	digestive
Benign neoplasm of breast	genitourinary
Uterine/Uterovaginal prolapse	genitourinary
Polyp of female genital organs	genitourinary
Complication of colostomy or enterostomy	injuries & poisonings
Alcoholic liver damage	mental disorders
Lupus (localized and systemic)	dermatologic
Peripheral vascular disease	circulatory system
Muscular dystrophies	neurological
Nephrotic syndrome without mention of glomerulonephritis	genitourinary
Occlusion and stenosis of precerebral arteries	circulatory system
Disorders of protein plasma/amino-acid transport and metabolism	endocrine/metabolic
Otitis media	sense organs
Chronic sinusitis	respiratory
Superficial cellulitis and abscess	dermatologic
Chronic hepatitis	infectious diseases
Disorders of menstruation and other abnormal bleeding from female genital tract	genitourinary
Obstructive chronic bronchitis	respiratory
Non-proliferative glomerulonephritis	genitourinary
Other abnormal blood chemistry	symptoms
Malignant neoplasm of other and ill-defined sites within the digestive organs and peritoneum	neoplasms
Deficiency of humoral immunity	endocrine/metabolic
Fracture of lower limb	injuries & poisonings
Antisocial/borderline personality disorder	mental disorders
Cerebrovascular disease	circulatory system
Benign neoplasm of ovary	neoplasms
Cancer of brain	neoplasms
Cardiac congenital anomalies	congenital anomalies
Other arthropathies	musculoskeletal
Osteoporosis	musculoskeletal
Cancer of brain and nervous system	neoplasms
Thyroid cancer	neoplasms
Atopic/contact dermatitis due to other or unspecified	dermatologic
Nontoxic uninodular goiter	endocrine/metabolic
Otosclerosis	sense organs
Macroglobulinemia	endocrine/metabolic
Chronic prostatitis	genitourinary
Otitis media and Eustachian tube disorders	sense organs
Chronic bronchitis	respiratory
Amyloidosis	endocrine/metabolic
Otitis externa	sense organs
Injury to other and unspecified nerves	injuries & poisonings
Abnormal results of function study of kidney	genitourinary
Colon cancer	neoplasms
Diseases of nail, NOS	dermatologic
Inflammation of the eye	sense organs
Atherosclerosis	circulatory system
stress incontinence, female	genitourinary
Other inflammatory disorders of male genital organs	genitourinary
Disorders of phosphorus metabolism	endocrine/metabolic
Other disorders of prostate	genitourinary
Benign mammary dysplasias	genitourinary
Arthropathy NOS	musculoskeletal
Enthesopathy	musculoskeletal
Atherosclerosis of the extremities	circulatory system
Generalized convulsive epilepsy	neurological
Primary biliary cirrhosis	digestive
Obstruction of bile duct	digestive
Symptoms involving cardiovascular system	circulatory system
Hyperparathyroidism	endocrine/metabolic
Viral warts & HPV	infectious diseases
Manlignant and unknown neoplasms of brain and nervous system	neoplasms
Certain early complications of trauma or procedure	injuries & poisonings
Disorders of vitreous body	sense organs
Cancer of other endocrine glands	neoplasms
Chronic pharyngitis and nasopharyngitis	respiratory
Polyneuropathy in diabetes	endocrine/metabolic
Immunity deficiency	endocrine/metabolic
Otorrhea	sense organs
Facial nerve disorders [CN7]	neurological
Inflammation of eyelids	sense organs
Peripheral or central vertigo	sense organs
Abnormal function study of cardiovascular system	circulatory system
Cancer within the respiratory system	neoplasms
Obsessive-compulsive disorders	mental disorders
Redundant prepuce and phimosis/BXO	genitourinary
Prolapse of vaginal walls	genitourinary
Cardiac and circulatory congenital anomalies	congenital anomalies
Bladder neck obstruction	genitourinary
Acute pancreatitis	digestive
Other nonmalignant breast conditions	genitourinary
Disorders of other cranial nerves	neurological
Iron deficiency anemias, unspecified or not due to blood loss	hematopoietic
Primary angle-closure glaucoma	sense organs
Calculus of ureter	genitourinary
Dermatitis herpetiformis	dermatologic
Other aneurysm	circulatory system
Cirrhosis of liver without mention of alcohol	digestive
Placenta previa and abruptio placenta	pregnancy complications
Malignant neoplasm of testis	neoplasms
Occlusion of cerebral arteries	circulatory system
Liver replaced by transplant	digestive
Other disorders of testis	genitourinary
Pain in limb	symptoms
Osteoarthrosis NOS	musculoskeletal
Cancer of other male genital organs	neoplasms
Umbilical cord complications during labor and delivery	pregnancy complications
Chorioretinal inflammations, scars, and other disorders of choroid	sense organs
Mild cognitive impairment	mental disorders
Nephritis and nephropathy without mention of glomerulonephritis	genitourinary
Malignant neoplasm of unspecified male genital organ	neoplasms
Pituitary hypofunction	endocrine/metabolic
Tachycardia NOS	circulatory system
Prurigo and Lichen	dermatologic
Abdominal pain	symptoms
Toxic effect of (non-ethyl) alcohol and petroleum and other solvents	injuries & poisonings
Acute (transverse) myelitis	neurological
Male infertility and abnormal spermatozoa	genitourinary
Cancer of connective tissue	neoplasms
Bipolar	mental disorders
Other disorders of bladder	genitourinary
Cervicitis and endocervicitis	genitourinary
Hypertrophy of salivary gland	digestive
Gastroesophageal laceration-hemorrhage syndrome	digestive
Nephritis and nephropathy with pathological lesion	genitourinary
Pyelonephritis	genitourinary
Open wound or laceration of eye or eyelid	injuries & poisonings
Malignant neoplasm of small intestine, including duodenum	neoplasms
Open-angle glaucoma	sense organs
Pericarditis	circulatory system
Raynaud's syndrome	circulatory system
Ventral hernia	digestive
Disorders involving the immune mechanism	endocrine/metabolic
Abnormality of gait	neurological
Portal hypertension	digestive
Pemphigus and pemphigoid	dermatologic
Rosacea	dermatologic
Rupture of tendon, nontraumatic	musculoskeletal
Late effects of musculoskeletal and connective tissue injuries	injuries & poisonings
Glucocorticoid deficiency	endocrine/metabolic
Viral hepatitis	infectious diseases
Otalgia	sense organs
Hereditary disturbances in tooth structure	digestive
Fetal distress and abnormal forces of labor	pregnancy complications
Intestinal infection due to protozoa	infectious diseases
Acromegaly and gigantism	endocrine/metabolic
Malignant neoplasm of rectum, rectosigmoid junction, and anus	neoplasms
Malignant neoplasm of other urinary organs	neoplasms
Adrenal hyperfunction	endocrine/metabolic
Infection of the eye	sense organs
Noninflammatory disorders of cervix	genitourinary
Seborrheic dermatitis	dermatologic
Symptoms concerning nutrition, metabolism, and development	injuries & poisonings
Impacted cerumen	sense organs
Diseases of esophagus	digestive
Cancer of bronchus; lung	neoplasms
Other diseases of blood and blood-forming organs	hematopoietic
Endometriosis	genitourinary
Hemorrhagic disorder due to intrinsic circulating anticoagulants	hematopoietic
Nonrheumatic tricuspid valve disorders	circulatory system
Cardiac pacemaker/device in situ	circulatory system
Sciatica	symptoms
Hyposmolality and/or hyponatremia	endocrine/metabolic
Heart valve disorders	circulatory system
Hypertrophic obstructive cardiomyopathy	circulatory system
Symptoms of the muscles	symptoms
Intestinal infection	infectious diseases
Primary open angle glaucoma	sense organs
Noninflammatory female genital disorders	genitourinary
Mood disorders	mental disorders
Abdominal aortic aneurysm	circulatory system
Impaction of intestine	digestive
Congestive heart failure; nonhypertensive	circulatory system
Polyarteritis nodosa and allied conditions	circulatory system
Other disorders of arteries and arterioles	circulatory system
Gastritis and duodenitis	digestive
Infertility, female	genitourinary
Acquired acanthosis nigricans	dermatologic
Toxic effect of other substances, chiefly nonmedicinal as to source	injuries & poisonings
Cancer of larynx, pharynx, nasal cavities	neoplasms
Varicose veins of lower extremity, symptomtic	circulatory system
Other and unspecified disc disorder	musculoskeletal
Malignant neoplasm of gallbladder and extrahepatic bile ducts	neoplasms
Cancer of eye	neoplasms
Aphakia and other disorders of lens	sense organs
Atherosclerosis of renal artery	circulatory system
Esophagitis, GERD and related diseases	digestive
Flatulence	digestive
Acute inflammatory pelvic disease	genitourinary
Hypertrophy of female genital organs	genitourinary
Fever of unknown origin	symptoms
Bacterial enteritis	infectious diseases
Visual disturbances	sense organs
Disorders of uterus, NEC	genitourinary
Congenital anomalies of genital organs	congenital anomalies
Adrenal hypofunction	endocrine/metabolic
Von willebrand's disease	hematopoietic
Myopia	sense organs
Labyrinthitis	sense organs
Heart failure NOS	circulatory system
Other complications of pregnancy NEC	pregnancy complications
Arthropathy associated with neurological disorders	musculoskeletal
Disorders of sacrum	musculoskeletal
Other disorders of synovium, tendon, and bursa	musculoskeletal
Other ill-defined and unknown causes of morbidity and mortality	injuries & poisonings
Iron deficiency anemia secondary to blood loss (chronic)	hematopoietic
Meningitis	neurological
Hemiplegia	neurological
Atherosclerosis of aorta	circulatory system
Arterial dissection	circulatory system
Benign neoplasm of respiratory and intrathoracic organs	neoplasms
Lymphadenitis	hematopoietic
Disorders of external ear	sense organs
Hypotension	circulatory system
Fracture of neck of femur	injuries & poisonings
Pituitary hyperfunction	endocrine/metabolic
Mastoiditis & related conditions	sense organs
Other local infections of skin and subcutaneous tissue	dermatologic
Endocarditis	circulatory system
Giant cell arteritis	circulatory system
Abnormal results of function study of liver	digestive
Cardiac shunt/ heart septal defect	congenital anomalies
Secondary hypothyroidism	endocrine/metabolic
Bronchiectasis	respiratory
Liver abscess and sequelae of chronic liver disease	digestive
Depression	mental disorders
Myopathy	neurological
Disorders of iris and ciliary body	sense organs
Symptomatic menopause	genitourinary
Disorders of coccyx	musculoskeletal
Nausea and vomiting	symptoms
Hypovolemia	endocrine/metabolic
Degenerative disease of the spinal cord	neurological
Nonspecific abnormal findings on radiological and other examination of skull and head	neurological
Disorders of conjunctiva	sense organs
Hallux rigidus	musculoskeletal
Superficial injury without mention of infection	injuries & poisonings
Adverse reaction to serum or vaccine	injuries & poisonings
Pulmonary congestion and hypostasis	respiratory
Nystagmus and other irregular eye movements	sense organs
Conductive hearing loss	sense organs
Chronic periodontitis	digestive
Diseases of the jaws	digestive
Sacroiliitis NEC	musculoskeletal
Malignant neoplasm of ovary and other uterine adnexa	neoplasms
Benign neoplasm of eye, uveal	neoplasms
Disturbance of salivary secretion	digestive
Infertility, male	genitourinary
Burns	injuries & poisonings
Cancer of larynx	neoplasms
Psychogenic and somatoform disorders	mental disorders
Other alveolar and parietoalveolar pneumonopathy	respiratory
Carditis	circulatory system
Jaundice (not of newborn)	digestive
Iatrogenic hypotension	circulatory system
Peptic ulcer (excl. esophageal)	digestive
Type 2 diabetes with renal manifestations	endocrine/metabolic
Other symptoms of respiratory system	respiratory
Hidradenitis	dermatologic
Complications of surgical and medical procedures	injuries & poisonings
Benign neoplasm of bone and articular cartilage	neoplasms
Benign neoplasm of pituitary gland and craniopharyngeal duct (pouch)	neoplasms
Disorders of parathyroid gland	endocrine/metabolic
Diseases of white blood cells	hematopoietic
Osteoarthrosis, localized, secondary	musculoskeletal
Other nondiabetic retinopathy	sense organs
Cyst of bone	musculoskeletal
Osteoporosis, osteopenia and pathological fracture	musculoskeletal
Parkinson's disease	neurological
Abnormal movement	neurological
Symptoms involving respiratory system and other chest symptoms	respiratory
Pallor and flushing	symptoms
Cancer of major salivary glands	neoplasms
Other disorders of lipoid metabolism	endocrine/metabolic
Hemoptysis	respiratory
Hormones and synthetic substitutes causing adverse effects in therapeutic use	injuries & poisonings
Eosinophilia	hematopoietic
Neoplasm of uncertain behavior	neoplasms
Hyperpotassemia	endocrine/metabolic
Disturbance of skin sensation	dermatologic
Spondylosis and allied disorders	musculoskeletal
Dystrophy of female genital tract	genitourinary
Pain and other symptoms associated with female genital organs	genitourinary
Mechanical complication of unspecified genitourinary device, implant, and graft	injuries & poisonings
Spinal cord injury without evidence of spinal bone injury	injuries & poisonings
Chemotherapy	neoplasms
Convulsions	neurological
Constipation	digestive
Diseases of pancreas	digestive
Exophthalmos	endocrine/metabolic
Intestinal disaccharidase deficiencies and disaccharide malabsorption	endocrine/metabolic
Spina bifida	congenital anomalies
Cancer of other female genital organs	neoplasms
Congenital osteodystrophies	congenital anomalies
Cerebral edema and compression of brain	neurological
Disturbances in tooth eruption	digestive
Disorders of sweat glands	dermatologic
Fracture of ankle and foot	injuries & poisonings
Open wound of foot except toe(s) alone	injuries & poisonings
Other venous embolism and thrombosis	circulatory system
Other diseases of the teeth and supporting structures	digestive
Glomerulonephritis	genitourinary
Supraventricular premature beats	circulatory system
Aortic aneurysm	circulatory system
Stricture and stenosis of esophagus	digestive
Other tests	injuries & poisonings
Paralytic strabismus	sense organs
Bullous dermatoses	dermatologic
Other and unspecified congenital anomalies	congenital anomalies
Megaloblastic anemia	hematopoietic
Ptosis of eyelid	sense organs
Synoviopathy	musculoskeletal
Rheumatism, unspecified and fibrositis	musculoskeletal
Articular cartilage disorder	musculoskeletal
Poisoning by analgesics, antipyretics, and antirheumatics	injuries & poisonings
Adverse effects of sedatives or other central nervous system depressants and anesthetics	injuries & poisonings
Hodgkin's disease	neoplasms
Mixed hyperlipidemia	endocrine/metabolic
Cholesteatoma	sense organs
Adverse drug events and drug allergies	injuries & poisonings
Subjective visual disturbances	sense organs
Hemorrhage during pregnancy; childbirth and postpartum	pregnancy complications
Sensorineural hearing loss	sense organs
Primary pulmonary hypertension	circulatory system
Respiratory arrest	respiratory
Diseases of pulp and periapical tissues	digestive
Acidosis	endocrine/metabolic
Decreased white blood cell count	hematopoietic
Atrophy of edentulous alveolar ridge	digestive
Hydronephrosis	genitourinary
Neutropenia	hematopoietic
Other disorders of eye	sense organs
Shortness of breath	respiratory
Glossitis	digestive
Myeloid leukemia, acute	neoplasms
Wegener's granulomatosis	circulatory system
Other acquired musculoskeletal deformity	musculoskeletal
Primary/intrinsic cardiomyopathies	circulatory system
Arteritis NOS	circulatory system
Opiates and related narcotics causing adverse effects in therapeutic use	injuries & poisonings
Other CNS infection and poliomyelitis	neurological
Hypertensive heart and/or renal disease	circulatory system
Other high-risk pregnancy	pregnancy complications
Disorder of skin and subcutaneous tissue NOS	dermatologic
Erythematosquamous dermatosis	dermatologic
Keloid scar	dermatologic
Hemarthrosis	musculoskeletal
Hyperosmolality and/or hypernatremia	endocrine/metabolic
Other deficiency anemia	hematopoietic
Autoimmune hemolytic anemias	hematopoietic
Stricture of artery	circulatory system
Toxic effect of noxious substances eaten as food	injuries & poisonings
Other disorders of urethra and urinary tract	genitourinary
Congenital anomalies of male genital organs	congenital anomalies
Cancer of other female genital organs (excluding uterus and ovary)	neoplasms
Abnormal spermatozoa	genitourinary
Panniculitis	musculoskeletal
Hereditary retinal dystrophies	sense organs
Chronic laryngitis	respiratory
Tuberculosis	infectious diseases
Eustachian tube disorders	sense organs
Congenital anomalies of peripheral vascular system	congenital anomalies
Atrophy of female genital tract	genitourinary
Fracture of foot	injuries & poisonings
Bacterial infection NOS	infectious diseases
Malignant neoplasm, other	neoplasms
Late pregnancy and failed induction	pregnancy complications
Osteochondropathies	musculoskeletal
Lymphoid leukemia, chronic	neoplasms
Atrioventricular [AV] block	circulatory system
Pneumococcal pneumonia	respiratory
Gingival and periodontal diseases	digestive
Diarrhea	digestive
Symptoms involving head and neck	mental disorders
Epistaxis or throat hemorrhage	respiratory
Pleurisy; pleural effusion	respiratory
Sialolithiasis	digestive
Ulcer of esophagus	digestive
Chronic glomerulonephritis, NOS	genitourinary
Traumatic amputation	injuries & poisonings
Disease of capillaries	circulatory system
Hypotension NOS	circulatory system
Abnormal sputum	respiratory
Hammer toe (acquired)	musculoskeletal
Pneumoconiosis	respiratory
Cholangitis	digestive
Streptococcus infection	infectious diseases
Disturbances of sensation of smell and taste	neurological
Other specified diffuse diseases of connective tissue	dermatologic
Inflammatory and toxic neuropathy	neurological
Vitiligo	dermatologic
Cancer of the mouth floor	neoplasms
Other disorders of middle ear and mastoid	sense organs
Secondary malignancy of lymph nodes	neoplasms
Neurofibromatosis	neoplasms
Lump or mass in breast	genitourinary
Open wound of neck	injuries & poisonings
Nerve plexus lesions	neurological
Heart valve replaced	circulatory system
Cancer of esophagus	neoplasms
Cervical cancer	neoplasms
Sleep disorders	neurological
Other specified erythematous conditions	dermatologic
Malignant neoplasm of ovary	neoplasms
Abnormal weight gain	endocrine/metabolic
Elevated blood pressure reading without diagnosis of hypertension	circulatory system
Acute pharyngitis	respiratory
Bronchitis	respiratory
Disorders of diaphragm	respiratory
Peritoneal or intestinal adhesions	digestive
Personal history of diseases of digestive system	digestive
Abnormal serum enzyme levels	digestive
Acute cystitis	genitourinary
Curvature of spine	musculoskeletal
Pathologic fracture	musculoskeletal
Congenital musculoskeletal deformities of spine	congenital anomalies
Nonspecific abnormal findings on radiological and other examination of musculoskeletal system	symptoms
Complications of cardiac/vascular device, implant, and graft	injuries & poisonings
Chronic dermatitis due to solar radiation	injuries & poisonings
Anticoagulants causing adverse effects	injuries & poisonings
Gram negative septicemia	infectious diseases
Dermatophytosis	infectious diseases
Rickets or osteomalacia	endocrine/metabolic
Other cardiac conduction disorders	circulatory system
Lung disease due to external agents	respiratory
Stomatitis and mucositis (ulcerative)	digestive
Noninfectious gastroenteritis	digestive
Nonspecific abnormal findings on radiological and other examination of biliary tract	digestive
Chronic renal failure [CKD]	genitourinary
Inflammatory diseases of uterus, except cervix	genitourinary
Systemic sclerosis	dermatologic
Intervertebral disc disorders	musculoskeletal
Contracture of tendon (sheath)	musculoskeletal
Costochondritis	musculoskeletal
Kyphoscoliosis and scoliosis	musculoskeletal
Difficulty in walking	musculoskeletal
Congenital anomalies of mouth/tongue	congenital anomalies
Fracture of pelvis	injuries & poisonings
Open wound of hand except finger(s)	injuries & poisonings
Broken tooth	injuries & poisonings
Poisoning by agents primarily affecting blood constituents	injuries & poisonings
Effects of other external causes	injuries & poisonings
Dermatophytosis / Dermatomycosis	infectious diseases
Secondary malignant neoplasm of liver	neoplasms
Leukemia	neoplasms
Benign neoplasm of parathyroid gland	neoplasms
Toxic multinodular goiter	endocrine/metabolic
Other disorders of neurohypophysis	endocrine/metabolic
Hyperaldosteronism	endocrine/metabolic
Protein-calorie malnutrition	endocrine/metabolic
Alkalosis	endocrine/metabolic
Major depressive disorder	mental disorders
Epilepsy, recurrent seizures, convulsions	neurological
Keratitis	sense organs
Aneurysm and dissection of heart	circulatory system
ASCVD	circulatory system
Cardiomyopathy	circulatory system
Second degree AV block	circulatory system
Congestive heart failure (CHF) NOS	circulatory system
Acute tonsillitis	respiratory
Empyema and pneumothorax	respiratory
Inflammatory conditions of jaw	digestive
Dysphagia	digestive
Nonspecific abnormal findings in stool contents	digestive
Dysuria	genitourinary
Other symptoms involving urinary system	genitourinary
Inflammatory diseases of female pelvic organs	genitourinary
Irregular menstrual cycle	genitourinary
Preeclampsia and eclampsia	pregnancy complications
Other conditions or status of the mother complicating pregnancy, childbirth, or the puerperium	pregnancy complications
Osteomyelitis	musculoskeletal
Arthropathy associated with infections	musculoskeletal
Loose body in joint	musculoskeletal
Candidiasis	infectious diseases
Large cell lymphoma	neoplasms
Multiple myeloma	neoplasms
Disorders of carbohydrate transport and metabolism	endocrine/metabolic
Acid-base balance disorder	endocrine/metabolic
Cerebral degeneration, unspecified	neurological
Migrain with aura	neurological
Eye infection, viral	sense organs
Strabismus and other disorders of binocular eye movements	sense organs
Cerebral atherosclerosis	circulatory system
Paralysis/spasm of vocal cords or larynx	respiratory
Acute and chronic tonsillitis	respiratory
Renal failure NOS	genitourinary
Congenital anomalies of breast	genitourinary
Abscess or ulceration of vulva	genitourinary
Dysplasia of female genital organs	genitourinary
Postmenopausal bleeding	genitourinary
Acne	dermatologic
Ankylosis of joint	musculoskeletal
Congenital anomalies of muscle, tendon, fascia, and connective tissue	congenital anomalies
Bone marrow or stem cell transplant	neoplasms
Infusion and transfusion reaction	injuries & poisonings
Secondary malignant neoplasm	neoplasms
Personal history of diseases of blood and blood-forming organs	hematopoietic
Delirium due to conditions classified elsewhere	mental disorders
Paranoid disorders	mental disorders
Psychosis	mental disorders
Tension headache	mental disorders
Diplopia and disorders of binocular vision	sense organs
Nonrheumatic aortic valve disorders	circulatory system
Precordial pain	circulatory system
Cardiac pacemaker in situ	circulatory system
Peripheral angiopathy in diseases classified elsewhere	circulatory system
Ulceration of the lower GI tract	digestive
Symptoms involving digestive system	digestive
Proliferative glomerulonephritis	genitourinary
Anatomical abnormatilies of kidney and ureters	genitourinary
Calculus of lower urinary tract	genitourinary
Congenital anomalies of skin	dermatologic
Other specified congenital anomalies of nervous system	congenital anomalies
Congenital anomalies of the eye	congenital anomalies
Skull and face fracture and other intercranial injury	injuries & poisonings
Poisoning by psychotropic agents	injuries & poisonings
HIV infection, symptomatic	infectious diseases
Injury to blood vessels	injuries & poisonings
Benign neoplasm of other female genital organs	neoplasms
Vitamin D deficiency	endocrine/metabolic
Localized adiposity	endocrine/metabolic
Primary thrombocytopenia	hematopoietic
Somatoform disorder	mental disorders
Other mental disorder	mental disorders
Pervasive developmental disorders	mental disorders
Muscular dystrophies and other myopathies	neurological
Anisometropia	sense organs
Rheumatic disease of the heart valves	circulatory system
Chronic pulmonary heart disease	circulatory system
Cardiac conduction disorders	circulatory system
Premature beats	circulatory system
Cerebral aneurysm	circulatory system
Orthostatic hypotension	circulatory system
Pulmonary collapse; interstitial and compensatory emphysema	respiratory
Hypoventilation	respiratory
Periapical abscess	digestive
Anomalies of tooth position/malocclusion	digestive
Disorders of esophageal motility	digestive
Functional digestive disorders	digestive
Ascites (non malignant)	digestive
Mucous polyp of cervix	genitourinary
Other disorders of the breast associated with childbirth and disorders of lactation	pregnancy complications
Unspecified osteomyelitis	musculoskeletal
Other symptoms referable to back	musculoskeletal
Lower gastrointestinal congenital anomalies	congenital anomalies
Congenital anomaly of gallbladder, bile ducts, liver, pancreas	congenital anomalies
Nonspecific abnormal findings on radiological and other examination of other intrathoracic organs (echocardiogram, etc)	symptoms
Fracture of ribs	injuries & poisonings
Torus fracture	injuries & poisonings
Iatrogenic endocrine disorders	endocrine/metabolic
Crystal arthropathies	endocrine/metabolic
Anxiety disorder	mental disorders
Hydrocephalus	neurological
Epilepsy	neurological
Corneal degenerations	sense organs
Fibroadenosis of breast	genitourinary
Vaginitis and vulvovaginitis	genitourinary
Antepartum hemorrhage, abruptio placentae, and placenta previa	pregnancy complications
Laxity of ligament or hypermobility syndrome	musculoskeletal
Neuralgia, neuritis, and radiculitis NOS	symptoms
Antirheumatics causing adverse effects in therapeutic use	injuries & poisonings
Salicylates causing adverse effects in therapeutic use	injuries & poisonings
Antihypertensive agents causing adverse effects	injuries & poisonings
Viral hepatitis A	infectious diseases
Viral hepatitis B	infectious diseases
Cancer of mouth	neoplasms
Malignant neoplasm of kidney, except pelvis	neoplasms
Cancer, suspected or other	neoplasms
Other hereditary hemolytic anemias	hematopoietic
Other demyelinating diseases of central nervous system	neurological
Hearing loss	sense organs
Respiratory failure, insufficiency, arrest	respiratory
Wheezing	respiratory
Anomalies of jaw size/symmetry	digestive
Cellulitis and abscess of oral soft tissues	digestive
Orchitis and epididymitis	genitourinary
Abnormal findings on mammogram or breast exam	genitourinary
Early onset of delivery	pregnancy complications
Pilonidal cyst	dermatologic
Cystic kidney disease	congenital anomalies
Poisoning by agents primarily affecting the cardiovascular system	injuries & poisonings
Other abnormal glucose	endocrine/metabolic
Iron deficiency anemias	hematopoietic
Phobia	mental disorders
Corneal edema	sense organs
Aneurysm of iliac artery	circulatory system
Chronic venous insufficiency [CVI]	circulatory system
Diseases of the larynx and vocal cords	respiratory
Leukoplakia of oral mucosa	digestive
Chronic pancreatitis	digestive
Cyst and pseudocyst of pancreas	digestive
Retention of urine	genitourinary
Cellulitis and abscess of face/neck	dermatologic
Carbuncle and furuncle	dermatologic
Musculoskeletal symptoms referable to limbs	symptoms
Injuries to the nervous system	injuries & poisonings
Asphyxia and hypoxemia	injuries & poisonings
Neoplasm of unspecified nature of digestive system	neoplasms
Hemangioma and lymphangioma, any site	neoplasms
Anorexia	endocrine/metabolic
Acquired hemolytic anemias	hematopoietic
Myasthenia gravis	neurological
Cornea replaced by transplant	sense organs
Other disorders of eyelids	sense organs
Nonrheumatic mitral valve disorders	circulatory system
Paroxysmal tachycardia, unspecified	circulatory system
Paralytic ileus	digestive
Complications of labor and delivery NEC	pregnancy complications
Corns and callosities	dermatologic
Circumscribed scleroderma	dermatologic
Infective connective tissue disorders	musculoskeletal
Congenital anomalies of face and neck	congenital anomalies
Digestive congenital anomalies	congenital anomalies
Neural tube defects	congenital anomalies
Traumatic arthropathy	injuries & poisonings
Poisoning by other anti-infectives	injuries & poisonings
Cancer of intrathoracic organs	neoplasms
Impaired fasting glucose	endocrine/metabolic
Ovarian dysfunction	endocrine/metabolic
Testicular hypofunction	endocrine/metabolic
Agorophobia, social phobia, and panic disorder	mental disorders
Encephalitis	neurological
Torsion dystonia	neurological
Hereditary and idiopathic peripheral neuropathy	neurological
Conjunctivitis, infectious	sense organs
Suppurative and unspecified otitis media	sense organs
Other hypertensive complications	circulatory system
Acute pericarditis	circulatory system
Acute laryngitis and tracheitis	respiratory
Respiratory complications	respiratory
Urethritis and urethral syndrome	genitourinary
Other signs and symptoms in breast	genitourinary
Cellulitis and abscess of fingers/toes	dermatologic
Toxic erythema	dermatologic
Keratoderma, acquired	dermatologic
Aseptic necrosis of bone	musculoskeletal
Acquired foot deformities	musculoskeletal
Acquired deformities of finger	musculoskeletal
Complication of internal orthopedic device	injuries & poisonings
Neoplasm of uncertain behavior of male genital organs	neoplasms
Cancer of kidney and renal pelvis	neoplasms
Coma	neurological
Ectropion or entropion	sense organs
Hypertensive chronic kidney disease	circulatory system
Nonspecific chest pain	circulatory system
Ventricular fibrillation and flutter	circulatory system
Acute upper respiratory infections of multiple or unspecified sites	respiratory
Throat pain	respiratory
Jaw disease NOS	digestive
Cyst of the salivary gland	digestive
Irritable Bowel Syndrome	digestive
Endometrial hyperplasia	genitourinary
Complications of in utero procedures	dermatologic
Rash and other nonspecific skin eruption	dermatologic
Other derangement of joint	musculoskeletal
Elevated sedimentation rate	symptoms
Gangrene	symptoms
Abnormal results of other function studies (bladder, pancreas, placenta, spleen, etc)	symptoms
Complications of transplants and reattached limbs	injuries & poisonings
Other symptoms	injuries & poisonings
Malignant neoplasm of retroperitoneum and peritoneum	neoplasms
Benign neoplasm of eye	neoplasms
Acquired hypothyroidism	endocrine/metabolic
Other paralytic syndromes	neurological
Myoneural disorders	neurological
Aortic valve disease	circulatory system
Painful respiration	respiratory
Abnormal findings examination of lungs	respiratory
Disorders of tooth development	digestive
GERD	digestive
Gastric ulcer	digestive
Blood in stool	digestive
Chronic ulcer of skin	dermatologic
Spondylosis with myelopathy	musculoskeletal
Fracture of humerus	injuries & poisonings
Septicemia	infectious diseases
Herpes zoster with nervous system complications	infectious diseases
Sexually transmitted infections (not HIV or hepatitis)	infectious diseases
Other benign neoplasm of connective and other soft tissue	neoplasms
Nevus, non-neoplastic	neoplasms
Other benign neoplasm of uterus	neoplasms
Type 2 diabetes with ketoacidosis	endocrine/metabolic
Acute reaction to stress	mental disorders
Personality disorders	mental disorders
Learning disorder	mental disorders
Other headache syndromes	neurological
Traumatic cataract	sense organs
Tympanosclerosis and middle ear disease related to otitis media	sense organs
Palpitations	circulatory system
Subdural hemorrhage	circulatory system
Pneumonia due to fungus (mycoses)	respiratory
Noninflammatory disorders of vagina	genitourinary
Genitourinary congenital anomalies	congenital anomalies
Toxic effect of other gases, fumes, or vapors	injuries & poisonings
Malignant neoplasm of uterus	neoplasms
Chronic lymphocytic thyroiditis	endocrine/metabolic
Alteration of consciousness	mental disorders
Blindness and low vision	sense organs
Other disorders of ear	sense organs
Bundle branch block	circulatory system
Cerebral ischemia	circulatory system
Influenza	respiratory
Hepatomegaly	digestive
Chronic interstitial cystitis	genitourinary
Menopausal and postmenopausal disorders	genitourinary
Postmenopausal atrophic vaginitis	genitourinary
Ectopic pregnancy	pregnancy complications
Vascular disorders of skin	dermatologic
Decubitus ulcer	dermatologic
Derangement of joint, non-traumatic	musculoskeletal
Pain in joint	musculoskeletal
Open wound of ear	injuries & poisonings
Malignant neoplasm of liver, primary	neoplasms
Benign neoplasm of brain and other parts of nervous system	neoplasms
Myoclonus	neurological
Retinoschisis and retinal cysts	sense organs
Abnormal heart sounds	circulatory system
Cardiomegaly	circulatory system
Allergic rhinitis	respiratory
Small kidney	genitourinary
Erythema nodosum	dermatologic
Joint effusions	musculoskeletal
Congenital anomalies of limbs	congenital anomalies
Anomalies of endocrine glands, congenital	congenital anomalies
Malaise and fatigue	symptoms
Sprains and strains	injuries & poisonings
Contusion	injuries & poisonings
Allergies, other	injuries & poisonings
Schizophrenia	mental disorders
Separation of retinal layers	sense organs
Visual field defects	sense organs
Perforation of tympanic membrane	sense organs
Mitral valve disease	circulatory system
Pseudomonal pneumonia	respiratory
Reflux esophagitis	digestive
Chronic cystitis	genitourinary
Erectile dysfunction [ED]	genitourinary
Chronic inflammatory pelvic disease	genitourinary
Early or threatened labor; hemorrhage in early pregnancy	pregnancy complications
Symptoms affecting skin	dermatologic
Other congenital anomalies of lower limb, including pelvic girdle	congenital anomalies
Abnormal Papanicolaou smear of cervix and cervical HPV	symptoms
Poisoning by primarily systemic agents	injuries & poisonings
Other infectious and parasitic diseases	infectious diseases
Chondrocalcinosis	endocrine/metabolic
Organic or persistent insomnia	neurological
Lack of coordination	neurological
Nerve root lesions	neurological
Nonsenile Cataract	sense organs
Other disorders of cervical region	musculoskeletal
Other specified osteoporosis	musculoskeletal
Urticaria	injuries & poisonings
Vitamin deficiency	endocrine/metabolic
Psychogenic disorder	mental disorders
Cardiac arrest	circulatory system
Stomatitis and mucositis	digestive
Urinary complications NEC	genitourinary
Inflammatory disease of breast	genitourinary
Alopecia	dermatologic
Rupture of synovium	musculoskeletal
Other open wound of head and face	injuries & poisonings
Human immunodeficiency virus [HIV] disease	infectious diseases
Arthropod-borne diseases	infectious diseases
Cancer of tongue	neoplasms
Cancer of bone and connective tissue	neoplasms
Diabetes insipidus	endocrine/metabolic
Disorders of magnesium metabolism	endocrine/metabolic
Swelling, mass, or lump in head and neck [Space-occupying lesion, intracranial NOS]	mental disorders
Encephalopathy, not elsewhere classified	neurological
Anomalies of pupillary function	sense organs
Subarachnoid hemorrhage	circulatory system
Aneurysm of other specified artery	circulatory system
Viral pneumonia	respiratory
Other symptoms/disorders or the urinary system	genitourinary
Osteomyelitis, periostitis, and other infections involving bone	musculoskeletal
Bursitis	musculoskeletal
Other congenital musculoskeletal anomalies	congenital anomalies
Concussion	injuries & poisonings
Dislocation	injuries & poisonings
Toxic effect of carbon monoxide	injuries & poisonings
Aspergillosis	infectious diseases
Abnormal glucose	endocrine/metabolic
Disorders of fluid, electrolyte, and acid-base balance	endocrine/metabolic
Disorders of lacrimal system	sense organs
Other heart block	circulatory system
Transient cerebral ischemia	circulatory system
Other diseases of respiratory system, NEC	respiratory
Diseases of hard tissues of teeth	digestive
Dentofacial anomalies, including malocclusion	digestive
Hemorrhage of gastrointestinal tract	digestive
Other and unspecified disorders of back	musculoskeletal
Malunion and nonunion of fracture	musculoskeletal
Symptoms and disorders of the joints	musculoskeletal
Congenital cataract and lens anomalies	congenital anomalies
Crushing or internal injury to organs	injuries & poisonings
Spirochetal infection	infectious diseases
Vascular hamartomas and non-neoplastic nevi	neoplasms
Atrioventricular block, complete	circulatory system
Hemorrhage NOS	circulatory system
Temporomandibular joint disorder, unspecified	digestive
Diseases of the oral soft tissues, excluding lesions specific for gingiva and tongue	digestive
Toxic gastroenteritis and colitis	digestive
Renal failure	genitourinary
Abnormal findings on examination of urine	genitourinary
Other abnormality of urination	genitourinary
Localized superficial swelling, mass, or lump	dermatologic
Other acquired deformities of limbs	musculoskeletal
Stiffness of joint	musculoskeletal
Fracture of clavicle or scapula	injuries & poisonings
Dermatitis due to solar radiation	injuries & poisonings
Anaphylactic shock NOS	injuries & poisonings
Mineral deficiency NEC	endocrine/metabolic
Electrolyte imbalance	endocrine/metabolic
Polycythemia, secondary	hematopoietic
Paroxysmal ventricular tachycardia	circulatory system
Heart transplant/surgery	circulatory system
Acute vascular insufficiency of intestine	circulatory system
Other specified gastritis	digestive
Hemorrhage in early pregnancy	pregnancy complications
Pathological, developmental or recurrent dislocation	musculoskeletal
Anomalies of respiratory system, congenital	congenital anomalies
Upper gastrointestinal congenital anomalies	congenital anomalies
Poisoning by anticonvulsants and anti-Parkinsonism drugs	injuries & poisonings
Cancer of oropharynx	neoplasms
Glycosuria or Acetonuria	endocrine/metabolic
Pain, swelling or discharge of eye	sense organs
Anomalous atrioventricular excitation	circulatory system
Arterial embolism and thrombosis	circulatory system
Chronic tonsillitis and adenoiditis	respiratory
Diverticulum of esophagus, acquired	digestive
Gastrointestinal complications	digestive
Disorders resulting from impaired renal function	genitourinary
Known or suspected fetal abnormality affecting management of mother	pregnancy complications
Pruritus and related conditions	dermatologic
Hyperhidrosis	dermatologic
Nonspecific findings on examination of blood	symptoms
Benign neoplasm of kidney and other urinary organs	neoplasms
Aphasia/speech disturbance	mental disorders
Eating disorder	mental disorders
Spinocerebellar disease	neurological
Astigmatism	sense organs
Tinnitus	sense organs
Peritoneal adhesions (postoperative) (postinfection)	digestive
Osteitis deformans [Paget's disease of bone]	musculoskeletal
Edema	symptoms
Postoperative shock	injuries & poisonings
Poisoning/allergy of sulfonamides	injuries & poisonings
Other disorders of thyroid	endocrine/metabolic
Type 2 diabetes with neurological manifestations	endocrine/metabolic
Develomental delays and disorders	mental disorders
Hypertensive heart disease	circulatory system
Noninfectious disorders of lymphatic channels	circulatory system
Encounter for long-term (current) use of anticoagulants, antithrombotics, aspirin	circulatory system
Oral aphthae	digestive
Gastrointestinal hemorrhage	digestive
Acute renal failure	genitourinary
Disorders secondary to childbirth, surgery, trauma	genitourinary
Malposition and malpresentation of fetus or obstruction	pregnancy complications
Pyogenic granuloma	dermatologic
Other allied disorders of spine	musculoskeletal
Degeneration of intervertebral disc	musculoskeletal
Juvenile osteochondrosis	musculoskeletal
Contracture of joint	musculoskeletal
Back pain	symptoms
Poisoning by agents primarily acting on the smooth and skeletal muscles and respiratory system	injuries & poisonings
Benign neoplasm of brain, cranial nerves, meninges	neoplasms
Chronic thyroiditis	endocrine/metabolic
Paraproteinemia	endocrine/metabolic
Peripheral retinal degenerations	sense organs
First degree AV block	circulatory system
Other diseases of respiratory system, not elsewhere classified	respiratory
Esophageal bleeding (varices/hemorrhage)	digestive
Peritonitis and retroperitoneal infections	digestive
Urinary tract infection	genitourinary
Excessive vomiting in pregnancy	pregnancy complications
Arthropathy associated with other disorders classified elsewhere	musculoskeletal
Other disorders of bone and cartilage	musculoskeletal
Allergic reaction to food	injuries & poisonings
Pancreatic cancer	neoplasms
Retinal detachment with retinal defect	sense organs
Corneal opacity	sense organs
Pulmonary embolism and infarction, acute	circulatory system
Aneurysm of artery of lower extremity	circulatory system
Other dyspnea	respiratory
Temporomandibular joint disorders	digestive
Sialoadenitis	digestive
Prostatitis	genitourinary
Symptoms involving female genital tract	genitourinary
Ingrowing nail	dermatologic
Chronic osteomyelitis	musculoskeletal
Other signs and symptoms involving emotional state	injuries & poisonings
Anxiety disorders	mental disorders
Migraine	neurological
Retinal hemorrhage/ischemia	sense organs
Disorders of refraction and accommodation; blindness and low vision	sense organs
Other diseases of lung	respiratory
Cysts of the jaws	digestive
Ulceration of intestine	digestive
Fibrosclerosis of breast	genitourinary
Cutaneous lupus erythematosus	dermatologic
Osteochondritis dissecans	musculoskeletal
Complication due to other implant and internal device	injuries & poisonings
Lymphoid leukemia	neoplasms
Pernicious anemia	hematopoietic
Other conditions of brain	neurological
Disorders of optic nerve and visual pathways	sense organs
Arrhythmia (cardiac) NOS	circulatory system
Diseases of the salivary glands	digestive
Splenomegaly	digestive
Personal history of allergy to medicinal agents	injuries & poisonings
Benign neoplasm of lip, oral cavity, and pharynx	neoplasms
Testicular dysfunction	endocrine/metabolic
Vitamin B-complex deficiencies	endocrine/metabolic
Vertiginous syndromes and other disorders of vestibular system	sense organs
Disease of tricuspid valve	circulatory system
Pneumonia	respiratory
Hyperventilation	respiratory
Other intestinal obstruction	digestive
Intracranial hemorrhage (injury)	injuries & poisonings
Cancer of liver and intrahepatic bile duct	neoplasms
Gouty arthropathy	endocrine/metabolic
Generalized anxiety disorder	mental disorders
Extrapyramidal disease and abnormal movement disorders	neurological
Abnormal involuntary movements	neurological
Hypermetropia	sense organs
Cyst of kidney, acquired	genitourinary
Osteitis deformans and osteopathies associated with other disorders classified elsewhere	musculoskeletal
Viral Enteritis	infectious diseases
Varicella infection	infectious diseases
Benign neoplasm of male genital organs	neoplasms
Ill-defined descriptions and complications of heart disease	circulatory system
Atrophic gastritis	digestive
Inflammatory diseases of prostate	genitourinary
Dyspareunia	genitourinary
Synovitis and tenosynovitis	musculoskeletal
Flat foot	musculoskeletal
Acquired toe deformities	musculoskeletal
Acquired spondylolisthesis	musculoskeletal
Cervicalgia	symptoms
Poisoning by agents primarily affecting the gastrointestinal system	injuries & poisonings
Hepatitis NOS	infectious diseases
Injury, NOS	injuries & poisonings
Cancer of stomach	neoplasms
Meniere's disease	sense organs
Myocarditis	circulatory system
Acute bronchitis and bronchiolitis	respiratory
Heartburn	digestive
Dyspepsia and other specified disorders of function of stomach	digestive
Hemorrhage of rectum and anus	digestive
Urinary obstruction	genitourinary
Fracture of tibia and fibula	injuries & poisonings
Benign neoplasm of spinal cord, meninges	neoplasms
Sexual and gender identity disorders	mental disorders
Partial epilepsy	neurological
Dental caries	digestive
Other symptoms involving abdomen and pelvis	digestive
Pelvic peritoneal adhesions, female (postoperative) (postinfection)	genitourinary
Prolapse of vaginal vault after hysterectomy	genitourinary
Herpes zoster	infectious diseases
Secondary malignancy of respiratory organs	neoplasms
Myeloid leukemia, chronic	neoplasms
Autism	mental disorders
Corneal ulcer	sense organs
Vascular insufficiency of intestine	circulatory system
Arterial embolism and thrombosis of lower extremity artery	circulatory system
Mastodynia	genitourinary
Pelvic inflammatory disease (PID)	genitourinary
Chronic fatigue syndrome	symptoms
Open wound of nose and sinus	injuries & poisonings
Foreign body injury	injuries & poisonings
Adjustment reaction	mental disorders
Alcoholism	mental disorders
Chorioretinal scars	sense organs
Voice disturbance	respiratory
Cough	respiratory
Acute periodontitis	digestive
Inflammatory disease of cervix, vagina, and vulva	genitourinary
Unspecified disorder of lipoid metabolism	endocrine/metabolic
Thrombocytopenia	hematopoietic
Specific nonpsychotic mental disorders due to brain damage	mental disorders
Cerebral cysts	neurological
Sinoatrial node dysfunction (Bradycardia)	circulatory system
Other upper respiratory disease	respiratory
Other hypertrophic and atrophic conditions of skin	dermatologic
Spontaneous ecchymoses	hematopoietic
Dependence on respirator [Ventilator] or supplemental oxygen	respiratory
Other complications of the puerperium NEC	pregnancy complications
Effects radiation NOS	injuries & poisonings
Althete's foot	infectious diseases
Renal colic	genitourinary
Hypertension complicating pregnancy, childbirth, and the puerperium	pregnancy complications
Herpes simplex	infectious diseases
Hypopotassemia	endocrine/metabolic
Transient mental disorders due to conditions classified elsewhere	mental disorders
Disorders of the globe	sense organs
Diseases of lips	digestive
Lymphoid leukemia, acute	neoplasms
Acute posthemorrhagic anemia	hematopoietic
Hallucinations	mental disorders
Polyneuropathy due to drugs	mental disorders
Left bundle branch block	circulatory system
Other specified cardiac dysrhythmias	circulatory system
Noninflammatory disorders of vulva and perineum	genitourinary
Poisoning by drugs primarily affecting the autonomic nervous system	injuries & poisonings
Gram positive septicemia	infectious diseases
Bone cancer	neoplasms
Neoplasm of uncertain behavior of skin	neoplasms
Secondary malignancy of bone	neoplasms
Asthma with exacerbation	respiratory
Torticollis	musculoskeletal
Fracture of unspecified part of femur	injuries & poisonings
Memory loss	mental disorders
Cystic mastopathy	genitourinary
Chromosomal anomalies and genetic disorders	congenital anomalies
Poisoning by hormones and synthetic substitutes	injuries & poisonings
Anemia of chronic disease	hematopoietic
Allergic purpura	hematopoietic
Disorders of the orbit	sense organs
Other forms of chronic heart disease	circulatory system
Renal dialysis	genitourinary
Unspecified erythematous condition	dermatologic
Peripheral enthesopathies and allied syndromes	musculoskeletal
Viral hepatitis C	infectious diseases
Purpura and other hemorrhagic conditions	hematopoietic
Intestinal malabsorption (non-celiac)	digestive
Pelvic inflammatory disease, NOS	genitourinary
Abnormal granulation tissue	dermatologic
Congenital anomalies of intestine	congenital anomalies
Poisoning by water, mineral, and uric acid metabolism drugs	injuries & poisonings
Staphylococcus infections	infectious diseases
Disorders of the pituitary gland and its hypothalamic control	endocrine/metabolic
Anemia in neoplastic disease	hematopoietic
Trigeminal nerve disorders [CN5]	neurological
Amblyopia	sense organs
Strabismus (not specified as paralytic)	sense organs
Cardiac arrest and ventricular fibrillation	circulatory system
Neoplasm of uncertain behavior of breast	neoplasms
Speech and language disorder	mental disorders
Unspecified polyarthropathy or polyarthritis	musculoskeletal
Congenital anomalies of urinary system	congenital anomalies
Malignant neoplasm of renal pelvis	neoplasms
Cushing's syndrome	endocrine/metabolic
Proteinuria	endocrine/metabolic
Other and unspecified complications of birth; puerperium affecting management of mother	pregnancy complications
Venous/cerebrovascular complications embolism in pregnancy and the puerperium	pregnancy complications
Secondary malignancy of brain/spine	neoplasms
Cerebral artery occlusion, with cerebral infarction	circulatory system
Respiratory failure	respiratory
Other specified diseases of the salivary glands	digestive
Other disorders of liver	digestive
Balanoposthitis	genitourinary
Abnormal mammogram	genitourinary
Dysmenorrhea	genitourinary
Chondromalacia	musculoskeletal
Hemorrhage or hematoma complicating a procedure	injuries & poisonings
Other immunological findings	endocrine/metabolic
Sleep apnea	neurological
Extrinsic allergic alveolitis	respiratory
Premenstrual tension syndromes	genitourinary
Spinal stenosis	musculoskeletal
Valvular heart disease/ heart chambers	congenital anomalies
Postoperative infection	infectious diseases
Myeloid leukemia	neoplasms
Infantile cerebral palsy	neurological
Cysts of oral soft tissues	digestive
Myalgia and myositis unspecified	symptoms
Shock	symptoms
Infection/inflammation of internal prosthetic device; implant; and graft	infectious diseases
Nonrheumatic pulmonary valve disorders	circulatory system
Hyperemesis gravidarum	pregnancy complications
Benign neoplasm of other endocrine glands and related structures	neoplasms
Abnormality of red blood cells	hematopoietic
Respiratory abnormalities	respiratory
Other nonspecific findings on examination of urine	genitourinary
Benign neoplasm of adrenal gland	neoplasms
Fluid overload	endocrine/metabolic
Dysthymic disorder	mental disorders
Pain	neurological
Epiphora	sense organs
Paroxysmal supraventricular tachycardia	circulatory system
Bacterial pneumonia	respiratory
Gingivitis	digestive
Premenopausal menorrhagia	genitourinary
Congenital deformities of feet	congenital anomalies
Dizziness and giddiness (Light-headedness and vertigo)	sense organs
Other acute and subacute forms of ischemic heart disease	circulatory system
Other cardiomyopathy	circulatory system
Other specified benign mammary dysplasias	genitourinary
Missed abortion/Hydatidiform mole	pregnancy complications
Nerve root and plexus disorders	neurological
Other disorders of stomach and duodenum	digestive
Traumatic and surgical subcutaneous emphysema	injuries & poisonings
Polycystic ovaries	endocrine/metabolic
Polydipsia	endocrine/metabolic
Other specified disorders of breast	genitourinary
Helminthiases	infectious diseases
Diseases and other conditions of the tongue	digestive
Nephritis; nephrosis; renal sclerosis	genitourinary
Noninflammatory disorders of ovary, fallopian tube, and broad ligament	genitourinary
Osteoarthrosis, localized, primary	musculoskeletal
Intestinal infection due to C. difficile	infectious diseases
Other vitamin B12 deficiency anemia	hematopoietic
Hemorrhage from gastrointestinal ulcer	digestive
Other disorders of intestine	digestive
Scar conditions and fibrosis of skin	dermatologic
Bursitis disorders	musculoskeletal
Periodontitis (acute or chronic)	digestive
Fracture of vertebral column without mention of spinal cord injury	injuries & poisonings
Problems associated with amniotic cavity and membranes	pregnancy complications
Insomnia	neurological
Breast disorder NOS	genitourinary
Congenital anomalies of female genital organs	congenital anomalies
Other persistent mental disorders due to conditions classified elsewhere	mental disorders
Septal Deviations/Turbinate Hypertrophy	respiratory
Infectious and parasitic complications affecting pregnancy	pregnancy complications
Dyschromia and Vitiligo	dermatologic
Effects of heat, cold and air pressure	injuries & poisonings
Dermatophytosis of nail	infectious diseases
Hypoparathyroidism	endocrine/metabolic
Deficiency anemias	hematopoietic
Keratoconus	sense organs
Peptic ulcer, site unspecified	digestive
Other disorders of the kidney and ureters	genitourinary
Intestinal helminthiases	infectious diseases
Folate-deficiency anemia	hematopoietic
Congenital factor VIII disorder	hematopoietic
Secondary thrombocytopenia	hematopoietic
Pneumonitis due to inhalation of food or vomitus	respiratory
Stricture/obstruction of ureter	genitourinary
Symptoms involving nervous and musculoskeletal systems	symptoms
Ulcerative colitis (chronic)	digestive
Spondylosis without myelopathy	musculoskeletal
Cystitis	genitourinary
Essential tremor	neurological
Other conditions of brain, NOS	neurological
Other disorders of tympanic membrane	sense organs
Other disorders of peritoneum	digestive
Other perinatal conditions of fetus or newborn	pregnancy complications
Other specified congenital anomalies of kidney	congenital anomalies
Multiple gestation	pregnancy complications
Other dyschromia	dermatologic
Other unspecified back disorders	musculoskeletal
Mycoses	infectious diseases
Cervical intraepithelial neoplasia [CIN] [Cervical dysplasia]	neoplasms
Lipoprotein disorders	endocrine/metabolic
Normal delivery	pregnancy complications
Cellulitis and abscess of trunk	dermatologic
Acute pain	neurological
Late effects of cerebrovascular disease	circulatory system
Miscarriage; stillbirth	pregnancy complications
Open wounds of head; neck; and trunk	injuries & poisonings
Irregular menstrual bleeding	genitourinary
Intracranial hemorrhage	circulatory system
Open wound of finger(s)	injuries & poisonings
Crushing injury	injuries & poisonings
Intracerebral hemorrhage	circulatory system
Aplastic anemia	hematopoietic
Cystitis and urethritis	genitourinary
Displacement of intervertebral disc	musculoskeletal
Osteoarthrosis, generalized	musculoskeletal
Late effect	injuries & poisonings
Acute sinusitis	respiratory
Respiratory insufficiency	respiratory
Hypertrophy of breast (Gynecomastia)	genitourinary
Fracture of unspecified bones	injuries & poisonings
Osteopenia or other disorder of bone and cartilage	musculoskeletal
Functional disorders of bladder	genitourinary
Breast conditions, congenital or relating to hormones	genitourinary
Cervical cancer and dysplasia	neoplasms
Benign neoplasm of thyroid glands	neoplasms
Chronic pain	neurological
Retinal vascular changes and abnomalities	sense organs
Intestinal obstruction without mention of hernia	digestive
Absent or infrequent menstruation	genitourinary
Postlaminectomy syndrome	musculoskeletal
Nervous system congenital anomalies	congenital anomalies
Chromosomal anomalies	congenital anomalies
Fracture of patella	injuries & poisonings
Sepsis and SIRS	injuries & poisonings
Sepsis	injuries & poisonings
Disorders of calcium/phosphorus metabolism	endocrine/metabolic
Posttraumatic stress disorder	mental disorders
Anterior horn cell disease	neurological
Disorders of the autonomic nervous system	neurological
Optic neuritis/neuropathy	sense organs
Right bundle branch block	circulatory system
Bronchopneumonia and lung abscess	respiratory
Other pulmonary inflamation or edema	respiratory
Abnormal findings on exam of gastrointestinal tract/ abdominal area	digestive
Vascular disorders of kidney/hypertrophy	genitourinary
Kidney replaced by transpant	genitourinary
Acute prostatitis	genitourinary
Changes in skin texture	dermatologic
Congenital hip dysplasia and deformity	congenital anomalies
Hypothermia/Chills	symptoms
Cardiogenic shock	symptoms
Cancer of of nasal cavities	neoplasms
Secondary malignant neoplasm of digestive systems	neoplasms
Other specified nonpsychotic and/or transient mental disorders	mental disorders
Schizophrenia and other psychotic disorders	mental disorders
Progressive myopia	sense organs
Hematemesis	digestive
Other disorders of male genital organs	genitourinary
Ovarian cyst	genitourinary
Other specified diseases of hair and hair follicles	dermatologic
Pyogenic arthritis	musculoskeletal
Thyroiditis	endocrine/metabolic
Diseases of spleen	hematopoietic
Frequency of urination and polyuria	genitourinary
Oliguria and anuria	genitourinary
Complication of amputation stump	injuries & poisonings
Secondary malignant neoplasm of skin	neoplasms
Cachexia	endocrine/metabolic
Optic atrophy	sense organs
Acute gastritis	digestive
Cyst or abscess of Bartholin's gland	genitourinary
Vaginal enterocele, congenital or acquired	genitourinary
Open wounds of extremities	injuries & poisonings
Poisoning by agents primarily affecting skin & mucous membrane, ophthalmological, otorhinolaryngological, & dental drugs	injuries & poisonings
Viral infection	infectious diseases
Diabetes or abnormal glucose tolerance complicating pregnancy	pregnancy complications
Villonodular synovitis	musculoskeletal
E. coli	infectious diseases
Other cerebral degenerations	neurological
Gastritis and duodenitis, NOS	digestive
Hyperglyceridemia	endocrine/metabolic
Peripheral autonomic neuropathy	neurological
Chronic pericarditis	circulatory system
Disorders of adrenal glands	endocrine/metabolic
Infections of genitourinary tract during pregnancy	pregnancy complications
Urethral stricture (not specified as infectious)	genitourinary
Other and unspecified disorders of the nervous system	neurological
Other endocrine disorders	endocrine/metabolic
Other hypertrophic cardiomyopathy	circulatory system
Suicide or self-inflicted injury	mental disorders